fdbibjhjj	TRUE
iaijfiehieai	TRUE
ihgdhbeefbddhgcaab	TRUE
bbieiicgjgjgahgdi	TRUE
bdaffgfcfbiaggcg	TRUE
bdgfagehgdcaideeae	TRUE
ffibdah	TRUE
fdfijcjfbaiheejfhe	TRUE
iaijfiehieaigbice	TRUE
iheejfh	TRUE
eaigbiceiidgedidgbdb	TRUE
gfcecggjbbefchchhi	TRUE
fdfijcb	TRUE
eci	TRUE
hdfdgeacfbjbgjhdcadc	TRUE
cgfebfchcjaccdbaie	TRUE
adjgjjbfiaj	TRUE
dcggdcacccgfebfchcjacb	TRUE
fjgggeighgb	TRUE
hfcfjjc	TRUE
ccdjfdhgffdhcegaifib	TRUE
fagehgdc	TRUE
cfj	TRUE
aehfdjjgaajihjgjfda	TRUE
ggcedggjjiifb	TRUE
ajaahahdigjb	TRUE
aafcaficejjihdfdge	TRUE
bdecdeeiaa	TRUE
aideeaeegfcecggjbbb	TRUE
cdbaiecgbihcf	TRUE
bihcebdecdeeiaijfieh	TRUE
jdcddbjhdehhh	TRUE
aja	TRUE
gbdgfagehgd	TRUE
ffgfcfbiaggcedggjj	TRUE
iic	TRUE
fdbibjhjjcaffibdgidibb	TRUE
ha	TRUE
ha	TRUE
jbbefchchhgjdcdb	TRUE
ehfdjjgaajihjgjfd	TRUE
hieaigbiceiidgedidgbdb	TRUE
dhbgicejcjhjbhefdfija	TRUE
dib	TRUE
fcecggjbbefchb	TRUE
haa	TRUE
cccgfebfchcjaccdbai	TRUE
dcggdcacccgf	TRUE
ceah	TRUE
affibdgid	TRUE
djacadjgjjbfib	TRUE
ifbchfjbjachfidbaj	TRUE
djacadjgjjbf	TRUE
fbddhgcaehjdfhf	TRUE
dgedidgbdaffgfcfbiagg	TRUE
bdaffgfcfbia	TRUE
afcaficejjihdfdgeaj	TRUE
cgbihcebdecdeeiaijf	TRUE
jcjfbaiheejg	TRUE
heejfhegbdgfagehgdcaj	TRUE
edggjjiifbchfjbjachfb	TRUE
gdcacccgfebfchj	TRUE
gcedggjjiifb	TRUE
jbf	TRUE
bdgidibadfghcadhb	TRUE
cdjfdhgffdhcegaifib	TRUE
ffibdgidibadfgh	TRUE
ahahdigjahacfjg	TRUE
cccgfebfi	TRUE
hfcfdbibjj	TRUE
bdecdeeiaia	TRUE
bjhjjcaffibdg	TRUE
ahahdib	TRUE
hhj	TRUE
deeaeegfcecg	TRUE
eaeeh	TRUE
cdbaiecgbihcjf	TRUE
jjbfi	TRUE
hchhgjff	TRUE
aide	TRUE
eciahhj	TRUE
dcaideeaeegfcecg	TRUE
ah	TRUE
cadjgjjbfi	TRUE
acfbjbgjhdcadcig	TRUE
badfghai	TRUE
iheejfhegbdgfagehgdc	TRUE
jhdcadcigeibbieiiag	TRUE
iicefij	TRUE
aafcaficejjihdfdg	TRUE
jfhegbdgfagehgdcaideea	TRUE
gcbb	TRUE
jaccdbaieca	TRUE
ehfdjjgaajihjgji	TRUE
djacb	TRUE
bdgid	TRUE
jcjfba	TRUE
gg	TRUE
jdcddbjhdehhgdc	TRUE
gehgdcaideeaee	TRUE
aehfdjjgaajihjgjfd	TRUE
gcbbchaedjacadjgjjbfi	TRUE
jdcddbjhdehhgdcggdc	TRUE
cefijgeci	TRUE
jjbfiajaahahdigjaha	TRUE
fjgggeighfch	TRUE
ab	TRUE
ab	TRUE
h	TRUE
h	TRUE
h	TRUE
h	TRUE
h	TRUE
h	TRUE
h	TRUE
h	TRUE
h	TRUE
h	TRUE
h	TRUE
h	TRUE
jfbaiheejfhebf	TRUE
haedjacb	TRUE
caehjdfhfccbgbji	TRUE
jfbaiheejfh	TRUE
ffibdgidibadfghcada	TRUE
egfcecggjbbefchchhgjff	TRUE
ef	TRUE
fcfbiaggcedggjjiifba	TRUE
badfghcaf	TRUE
gbda	TRUE
cdbaiecgbihcebd	TRUE
eiba	TRUE
jfhegbdgf	TRUE
gbdgfagehgdcaid	TRUE
bdgfagehgdca	TRUE
dhbg	TRUE
haee	TRUE
eaeegfcec	TRUE
jdcddbjhdeb	TRUE
djacadj	TRUE
ejcaj	TRUE
hcadhbgicejcjhjbhefdab	TRUE
badfh	TRUE
deeiaijfiehieaigbicei	TRUE
ciahhj	TRUE
cbbchaedjacadjgjjbfiaj	TRUE
hahdib	TRUE
jahacfjgggeighgb	TRUE
fj	TRUE
jfbab	TRUE
hhjag	TRUE
cejcjhjbhefdfijcjfb	TRUE
fdfijcjfba	TRUE
jaha	TRUE
jfcdbhdceddbjieahafcb	TRUE
hgdhbeefbddhgcaehab	TRUE
hchhjb	TRUE
jjbfib	TRUE
idibab	TRUE
gge	TRUE
e	TRUE
e	TRUE
e	TRUE
e	TRUE
e	TRUE
e	TRUE
e	TRUE
e	TRUE
e	TRUE
gjbbefchb	TRUE
eaeegfcecggjbbb	TRUE
ciahhjagcbbe	TRUE
cdeeiaijfiehi	TRUE
ciahhjagcbbcha	TRUE
aajihjgjfdaaafcaficejj	TRUE
cggb	TRUE
ehdddijfcdbhdceddbji	TRUE
bbcha	TRUE
ahhjagcbbchaedjacb	TRUE
ia	TRUE
dhbgi	TRUE
efijgeciab	TRUE
afcaficejjihdfdg	TRUE
cefb	TRUE
ii	TRUE
fdb	TRUE
ffibdgid	TRUE
iahhjagi	TRUE
cdeeiaijfiehiea	TRUE
affibd	TRUE
cggjbbefchchh	TRUE
chfidbajaihgdhbea	TRUE
adjgjjbfiajaahaa	TRUE
jjbfiaj	TRUE
fjggge	TRUE
aeeh	TRUE
ehgdca	TRUE
ehieaigbic	TRUE
iaijfiehieaigb	TRUE
cfjgggeighfch	TRUE
idgedidgbdaffgfca	TRUE
hhgdcggdca	TRUE
ggh	TRUE
a	TRUE
a	TRUE
a	TRUE
a	TRUE
a	TRUE
a	TRUE
a	TRUE
a	TRUE
a	TRUE
a	TRUE
a	TRUE
a	TRUE
a	TRUE
hahdigjah	TRUE
iidgedidab	TRUE
iicef	TRUE
affibdgidb	TRUE
djacadjgjjbfiaj	TRUE
fjggg	TRUE
icejcjhjbheab	TRUE
ehgd	TRUE
eaeegfc	TRUE
fijgeciahhj	TRUE
icejcjhjbhefdfija	TRUE
fcfbiaggcedgga	TRUE
ee	TRUE
ffbh	TRUE
fbchfjbjacb	TRUE
jaahahdigjahacfjgggei	TRUE
fjgg	TRUE
ighgb	TRUE
eciahhjagcbbcha	TRUE
ehieaigbiceiidgedid	TRUE
jbbefchchhjb	TRUE
cdbaiecgba	TRUE
aff	TRUE
ffdhcegaifijjifgcddih	TRUE
ddbjhdehhgdcggdcacccb	TRUE
cab	TRUE
dcaid	TRUE
bdgidibadfghcada	TRUE
ifbchfjbjachfidbaja	TRUE
jdcddbjhdehhgdcggdca	TRUE
adjb	TRUE
aggcedggjji	TRUE
aajihjgjfdaaafcaficj	TRUE
cgfebfch	TRUE
ajbi	TRUE
fjgggeighfcfdbibjha	TRUE
hhjagcbbchaedjacadj	TRUE
geighfcfdbibjj	TRUE
icgjgjgahgdigccdjh	TRUE
fdfijcja	TRUE
ghfchj	TRUE
dcaideeaeegfc	TRUE
affibdgidibadf	TRUE
ebdecdeeiaijfieh	TRUE
jdcddbjhdehhgd	TRUE
ghf	TRUE
gcbbch	TRUE
g	TRUE
g	TRUE
g	TRUE
g	TRUE
g	TRUE
g	TRUE
g	TRUE
g	TRUE
jah	TRUE
acfbjbgjhdcadcigeibbi	TRUE
ciab	TRUE
gbdgfa	TRUE
bgbjdjgaehfdjjgaajihj	TRUE
dhbgic	TRUE
fbchfjbjachfij	TRUE
aajihjgjfdaaafc	TRUE
cfjgggeia	TRUE
heejfhegbdgfageh	TRUE
hgdhbeefbddhg	TRUE
bdaffgfcfbiaggcedgj	TRUE
hfjbjachfidbb	TRUE
ggcedggjjiifbchfb	TRUE
hahdigjahacfjg	TRUE
hcadhbgicejcaj	TRUE
hhgdcggdcacccgfi	TRUE
dhbgicejcaj	TRUE
hgdhbeefbddhgc	TRUE
ahahdigjahacfjgggeighf	TRUE
aeegfcecggjbbefchchhi	TRUE
jdcddbjhd	TRUE
jaihgdhbeefbddhgcaejc	TRUE
gcbbchaedja	TRUE
ccgfebfchcjaccdbaiec	TRUE
iicgjgjgahgdigccdjfdh	TRUE
adhbgicejcjhjbh	TRUE
hahdigjb	TRUE
bjj	TRUE
ffdhcegaifijjifgcb	TRUE
cggjbbefchb	TRUE
icejcjhjbheh	TRUE
cfjgggeighfcfdbjab	TRUE
jcjfbaihe	TRUE
ciahhjagcbbchaee	TRUE
ejcjhjbh	TRUE
gjaha	TRUE
hfidbajaihgdhbeefbddhg	TRUE
bdgidibadfh	TRUE
fij	TRUE
ideeaeegfcecggjbbefa	TRUE
ffibdgidibadfghcadhb	TRUE
fcecjf	TRUE
dcggdcacccgfebfch	TRUE
deeaee	TRUE
ecgbihcebdef	TRUE
hcadhbgidh	TRUE
ehjdfhfccbgbji	TRUE
edj	TRUE
jfdaaafcaficejjihdfdg	TRUE
gcbbchaedj	TRUE
heejfhegbdgfagehh	TRUE
dibadfghcadhb	TRUE
jjbfiajaahahdigjah	TRUE
bjhjjcaffibd	TRUE
jdcddbb	TRUE
hcebdecde	TRUE
jfhegbdgfageh	TRUE
jg	TRUE
f	TRUE
f	TRUE
f	TRUE
f	TRUE
f	TRUE
f	TRUE
f	TRUE
f	TRUE
f	TRUE
f	TRUE
f	TRUE
gehgdcaid	TRUE
biceiidgedid	TRUE
fageh	TRUE
jjiifbchfjbjachf	TRUE
fagehgdcaj	TRUE
j	TRUE
j	TRUE
j	TRUE
j	TRUE
j	TRUE
j	TRUE
j	TRUE
j	TRUE
j	TRUE
j	TRUE
j	TRUE
j	TRUE
j	TRUE
j	TRUE
j	TRUE
j	TRUE
j	TRUE
j	TRUE
jaccdbaiecgbihcjf	TRUE
hhjagcbbe	TRUE
hgdcaid	TRUE
hahdigjahacfjgggeiba	TRUE
bdg	TRUE
bbchaedjacadjgjjbfib	TRUE
heeb	TRUE
hfidbajaihgdhbeefbde	TRUE
cccgfgh	TRUE
gb	TRUE
cdbaiecgb	TRUE
ddihacjcdhggecjifha	TRUE
jcjhah	TRUE
ehfdjjgaajihjb	TRUE
cejcjhjbhefdfija	TRUE
hacfjgggei	TRUE
hfjbjachfidb	TRUE
cggjbbef	TRUE
aideeaeegfc	TRUE
gbihcebdecdeeiaijf	TRUE
jgeci	TRUE
jgeciahhjaggh	TRUE
hchhgjdcdb	TRUE
idibadfghcadhbgidh	TRUE
geighfcfdbibjha	TRUE
acfbjbgjhdcadcige	TRUE
dbajaihgdhbeefbh	TRUE
i	TRUE
i	TRUE
i	TRUE
i	TRUE
i	TRUE
i	TRUE
i	TRUE
i	TRUE
i	TRUE
i	TRUE
i	TRUE
i	TRUE
i	TRUE
i	TRUE
i	TRUE
i	TRUE
i	TRUE
i	TRUE
gbiceiidgedidab	TRUE
ggdcacccgfebfi	TRUE
ddihacjcdhggecjifhab	TRUE
heejfhegbd	TRUE
ccgfebfchj	TRUE
jfhei	TRUE
iahhjagcbbchaedja	TRUE
dgbdaffgfcfbi	TRUE
fjgggei	TRUE
ideeaeegfcecggjbb	TRUE
cfbjbgjhdcadcigeae	TRUE
jcja	TRUE
hcjaccdbaiecgbih	TRUE
ideeaeeh	TRUE
ceiidgedidgbdb	TRUE
jaccdbai	TRUE
hj	TRUE
fchchhgjdcddbjhdf	TRUE
edjacb	TRUE
dcggdcac	TRUE
cefijg	TRUE
icejcjhah	TRUE
aehjdfhfccbgbjdjgaeb	TRUE
fjgggeia	TRUE
jaahahdigj	TRUE
cggjbbb	TRUE
icejcjhjbhefdfijcjfb	TRUE
ci	TRUE
fdfijcjfbaiheeb	TRUE
jaahb	TRUE
fdbibjha	TRUE
hcjaccdbaiecgbihcebde	TRUE
adjgjjbfiajaahahd	TRUE
gdcacccgfebfi	TRUE
aehjdfhfccbgbjdjg	TRUE
aehjdfhfccbgbjdjgaehfh	TRUE
eaigbiceiidgedid	TRUE
idibadfghcaf	TRUE
iecgbihcebdecdeeiaijfi	TRUE
gjahacfjgggeighgb	TRUE
gj	TRUE
ddbjhdehhgdcggdcac	TRUE
icefijge	TRUE
hd	TRUE
heejfh	TRUE
cbgbjdjgaehfdjj	TRUE
hhgdcggdc	TRUE
gcbbcha	TRUE
dhbgidh	TRUE
fcfbiaggcedggjjiifbcha	TRUE
jjbfiaja	TRUE
cjcdhggecjifhaibaeehh	TRUE
aj	TRUE
geibbieiicgjgjgahgdi	TRUE
c	TRUE
c	TRUE
c	TRUE
c	TRUE
c	TRUE
c	TRUE
c	TRUE
c	TRUE
c	TRUE
c	TRUE
dgedidgbdab	TRUE
aigbiceiidged	TRUE
bfchcjaccdba	TRUE
hieaigbicei	TRUE
gh	TRUE
hhgdcgh	TRUE
edjacadjgjjbf	TRUE
ajaahahdigjah	TRUE
gdcacccgfgh	TRUE
ehieaigbiceiidgedb	TRUE
iheejfhegbdgfagehgd	TRUE
djacadjib	TRUE
aeegfcecjf	TRUE
aggcedggjjiifba	TRUE
heejfhei	TRUE
d	TRUE
d	TRUE
d	TRUE
d	TRUE
d	TRUE
d	TRUE
d	TRUE
d	TRUE
ahahdigjaha	TRUE
gbdgfag	TRUE
hfcfdbibjhjjcaffibdah	TRUE
hfidbajaihgdhbe	TRUE
hhiabbaabba	FALSE
ehgfieccheafgicacabbaabba	FALSE
ajcabcggbcaabba	FALSE
dhedficadffcdbcjiahbaabba	FALSE
fhbabaajcbebaabba	FALSE
dggahcijgfbhfdeihaebaabba	FALSE
dfddjgacghddihdaijbbaabba	FALSE
deadcjbbaabba	FALSE
bhaccbjiaddejaeeeaebaabba	FALSE
ccagbbjaabba	FALSE
diggjhcfhhbbaibabaabba	FALSE
jjjifjccdjhgbhdfeabbaabba	FALSE
bjhhjhhjafgbgbaabba	FALSE
gbabbaabba	FALSE
agibdcdbaabba	FALSE
dfebihbcjcchbfbjdabbaabba	FALSE
fhjfgabbaabba	FALSE
ahjahgabhhbijdbggfjgaabba	FALSE
igabfbaabba	FALSE
bebabbaabba	FALSE
cbghfbaeajeabbaabba	FALSE
dgjehhhgcgcddiiijabbaabba	FALSE
gfcbhafbbaabba	FALSE
ffcegfcbhafbbaabba	FALSE
iddhiddhafhjjfbabaabba	FALSE
dhjhihhbeabbaabba	FALSE
fhadbcbefaabba	FALSE
jifhbabaajcabcgaabba	FALSE
cchfjdidggaabbaabba	FALSE
egjhifgfbjccadfhabhbaabba	FALSE
idebecjjcfcagaefdcbbaabba	FALSE
iadggdabbaabba	FALSE
eajeaeghhhedagaibhbiaabba	FALSE
cdjdjcadhacfhdeijfbbaabba	FALSE
ahdifbiifcffabaebdiggabba	FALSE
abhijbaabba	FALSE
eidijaeceddfgffbdfbjaabba	FALSE
deadcbbaabba	FALSE
ecbaedjgebaabfghhaabba	FALSE
gdagfbdgcjjdcieigccbaabba	FALSE
ghjcdhccejadfahbhjibaabba	FALSE
ehgabfddebbaabba	FALSE
ccfchedddcbhbadbffhbaabba	FALSE
fgfggceehbijicehajbbaabba	FALSE
ebgaagefecbahcbajaaiggbba	FALSE
ajcabcggahhjabaabba	FALSE
eacdagafbheajiejcbigaabba	FALSE
hhhedagaibhfibeifaabba	FALSE
iafgdbafgdjdegfcbhaidabba	FALSE
agcibbaabba	FALSE
cfdchabbaabba	FALSE
heagbcdhjhihhbejbaabba	FALSE
agibdcdabaabba	FALSE
jijgfhgacbbiiafgfgabba	FALSE
dbcbeabbaabba	FALSE
hfjbjbagciddhiddibbaabba	FALSE
ejbcabbaabba	FALSE
gfcabbaabba	FALSE
bhcijdbeagbhdajeiebaabba	FALSE
jeiecadbcfghfjbaabba	FALSE
hegdeiffjdedddefagbbaabba	FALSE
giiabfbaabba	FALSE
jhegfhfiiciicdichabbaabba	FALSE
bcjbjeifhadjhfgciabbaabba	FALSE
ghfcdbcbefijaibbaabba	FALSE
djfhheajfjeeicgdefbbaabba	FALSE
hfcdbcbefijabbaabba	FALSE
deagibdcdfebihbcjgaabba	FALSE
cecfabcefeaejjjcfhgbaabba	FALSE
dgecdjiejhgabbaabba	FALSE
ddhiddhafhjjjbbaabba	FALSE
dacchfbibaabba	FALSE
fjcjjabbaabba	FALSE
bficeijhaebeidbedbjbaabba	FALSE
jhcfhhbbjbefddjabbaabba	FALSE
ahbbaabba	FALSE
jjdeffcegfecfabbaabba	FALSE
acgejbjbaabba	FALSE
egfjghjfgghccccdjabbaabba	FALSE
agbbaabba	FALSE
caecifibbjfjejgdaaabcjba	FALSE
dfabdcfijgiibcjjcigjaabba	FALSE
jccaaefejheiejgiaebbaabba	FALSE
bcjjabbaabba	FALSE
idieidibbabbaabba	FALSE
fbfajffaddficdjfjdbbaabba	FALSE
agbjbaabba	FALSE
cfiedbeefafaaebgbfageabba	FALSE
beghfcdbabbaabba	FALSE
hbahhcgbbbaabba	FALSE
cegdjffcchgiejjeiabbaabba	FALSE
ajifjcdbejiiaiicigabaabba	FALSE
gcidgjabbaabba	FALSE
dbafgdjdegfbbaabba	FALSE
adeiigehfbehjaijdccbaabba	FALSE
diibfbcfiajbajbcdacadjbba	FALSE
jhhajfcahfjeeaaajibbaabba	FALSE
hghbahbabaabba	FALSE
eedjahidideebfacgibbaabba	FALSE
cgejbcjgdcacjgihjbibaabba	FALSE
caecifibbjfaabba	FALSE
becbdadfdafgihgjdfbbaabba	FALSE
gdgjedbfajifejidfbhbaabba	FALSE
cbghfbaeajbjbaabba	FALSE
caecifibbjfjejgdajbjababa	FALSE
jhaaeiihbbjdiehaifbdjabba	FALSE
hfcdbcbefijaibbaabba	FALSE
accagbjiabaabba	FALSE
caecifibbjfjejgaabba	FALSE
bhcijabbaabba	FALSE
dffjhgafbfijhdjgjicbaabba	FALSE
jefhccjjfjgfajiafbbjaabba	FALSE
fabeibfaadijeajjhjdijcbba	FALSE
gciddhiddhafhjjfbjebaabba	FALSE
bjccgbdahbebijadgabcjcaba	FALSE
fjcjjdeffcegfcbhafbbaabba	FALSE
hchicbfccbcjaagfcibbaabba	FALSE
baedjgebabeaabba	FALSE
cbbiiafgdbafgbaabba	FALSE
fffhcegjafgaigfhbdbiaabba	FALSE
gaibhfibeifgjbaabba	FALSE
ajcbecibfcibgdcaabba	FALSE
icabjbaabba	FALSE
gfbhcihhidabbaabba	FALSE
dieidjaebbaabba	FALSE
chbefigbchjahjdgiabbaabba	FALSE
jfeagdeibjbaabba	FALSE
jcbcdjjbcgfjdbdeagbbaabba	FALSE
ibdcdfgbabbaabba	FALSE
dcbabbaabba	FALSE
abhijbidffaabba	FALSE
bgbbgahgfgiifchaihbbaabba	FALSE
dhjhihifabbaabba	FALSE
jgiibcjjcigiedacbbaabba	FALSE
bhegeijfbhdfifbdafbbaabba	FALSE
cjdjiiehgabfddbcaabba	FALSE
baedjhbbaabba	FALSE
cfdigcbjabbaabba	FALSE
bdcfiabbaabba	FALSE
ajeaegbbaabba	FALSE
chaehhcejfffjbfiaifbaabba	FALSE
accagbjiddbfcjadchabba	FALSE
jbbeabhijbidffacicaebba	FALSE
hadgecdjiejhcjeeibbaabba	FALSE
jcabcggbcaabba	FALSE
cjgihjbbabbaabba	FALSE
ibgdcfdddfghcaebbaabba	FALSE
ajcabcggahhjafbjaabba	FALSE
cifbjgabbaabba	FALSE
ejchbibibabbaabba	FALSE
jaaccagbjiddbfcjadchabba	FALSE
abfdbaabba	FALSE
agdbicdhdbeidjjdgcaibabba	FALSE
hjbbabbaabba	FALSE
aehbjhbfihghbfgbgcfgaabba	FALSE
ebeajabhibebadbgiijbcabba	FALSE
iecadbcfghfjbjbaggahbba	FALSE
beifgadbbaabba	FALSE
bbiibjgjjgahciafchbbaabba	FALSE
hffdjfigdgjjabbaabba	FALSE
bdcfijgiibcabbaabba	FALSE
ehfffbijegijdcaaigbbaabba	FALSE
bhijbidffacicabjbaabba	FALSE
jijgfhgabbaabba	FALSE
aedggjcjjjbbcejfihgjaabba	FALSE
dggdhdegabbaabba	FALSE
ebbeiijdhdjeiffagcbbaabba	FALSE
gbgchfcajijgfhgabbaabba	FALSE
baabibajedafjfjcgifbgdgba	FALSE
chbfbjdfababaabba	FALSE
dfceffhijacbbaabba	FALSE
hgabfddejhifbahabba	FALSE
jgfhgacbbiiaabba	FALSE
jcbecibfcibgdcfdjabbaabba	FALSE
dhgfjegigacibijjhdabaabba	FALSE
iiadggbbaabba	FALSE
djgebaabfghbgaabba	FALSE
idiggjhcfababaabba	FALSE
gciddhiddhabbaabba	FALSE
idfiddbifigedejaabbfaabba	FALSE
jeihjabbaabba	FALSE
caecifibbjfjejgafabba	FALSE
agciihhjhaegeahbbbiaahbba	FALSE
cggjciehcjgahbgfaiabaabba	FALSE
iehgabfddebbaabba	FALSE
cbabbaabba	FALSE
jgidjggjfgbbeejdbabbaabba	FALSE
fijfhiejchbibibabbaabba	FALSE
dgcbffdibbfiahbbaabba	FALSE
aabbaabba	FALSE
abhijbidffaciabba	FALSE
dicjgiajhjfeibhfdbceaabba	FALSE
ibdcdfafbbaabba	FALSE
dbafgdjdbbaabba	FALSE
jabbaabba	FALSE
jabbaabba	FALSE
biigfgahgecbabaabba	FALSE
jeihcbhechagefdfehbbaabba	FALSE
dbfajifejibbfaabba	FALSE
cbjhhjhabbaabba	FALSE
adacgaebhgaahgfgdfabaabba	FALSE
gfgahgebbeaabba	FALSE
difcjhicjjccbfgjaebbaabba	FALSE
adbbaabba	FALSE
ahbcbeafeihefijajcchibgba	FALSE
ffcegfecfabbaabba	FALSE
abhijbidffaiabcjba	FALSE
gfcbhaidieidiggjbjbaabba	FALSE
jdjbabbaabba	FALSE
gfcbabbaabba	FALSE
baedjgebaabfghhaagbba	FALSE
fijgibcabbaabba	FALSE
bgfeafhdedgggigihbcbaabba	FALSE
dagaibhfibeiaabba	FALSE
bciihjjiefeghiejdabbaabba	FALSE
chbfabbaabba	FALSE
cfffdjgcjdjiieababaabba	FALSE
igaieebejdhjjjicfiebaabba	FALSE
djabbaabba	FALSE
djabbaabba	FALSE
fgjfeagdeideadbbaabba	FALSE
afcdcjgfeeiccfjjgebbaabba	FALSE
agdbbaabba	FALSE
acbbaabba	FALSE
cffgbeegbdegidcdaebbaabba	FALSE
jhafdcifffjfigbjjhjbaabba	FALSE
cchfjdidgcbffdibabbaabba	FALSE
ibbgdihhbiadigbhaibiaabba	FALSE
cjgihjbibabbaabba	FALSE
hadgecdjiebjbaabba	FALSE
afabaefieaahbeabibeidabba	FALSE
gcbjhhjhhjafgjfbbaabba	FALSE
ibcdhfhcdbcjccfgjabbaabba	FALSE
fcabbaabba	FALSE
agaefiigbeeijghfjdgbaabba	FALSE
bijabbaabba	FALSE
gibdcdfebihbcjccabbaabba	FALSE
ijdbeagbhdbaabba	FALSE
bgicgigiifhcbccgfabbaabba	FALSE
jgfefhicicjbeeacjhbbaabba	FALSE
bhaidiebbaabba	FALSE
dbabbaabba	FALSE
gagbbaabba	FALSE
gdeideadbbaabba	FALSE
ddjcfjgfehhgjaaafibbaabba	FALSE
abfghhfjfegedbaabba	FALSE
gbhediaccdajjjbdfaabaabba	FALSE
gfefjbghfbggfgeejabbaabba	FALSE
agfdcgfjjaifecajgbibaabba	FALSE
ffiabgdbibbaebdeghaehfbba	FALSE
hbibiabbaabba	FALSE
bjhhjhabbaabba	FALSE
giadgecgfadcgejedjbbaabba	FALSE
jgihjbibhfjidhabbaabba	FALSE
acbbiiafgbabba	FALSE
ahacdgfhihhhgiahibibaabba	FALSE
ejfbbbgidaibbabdbfdfbabba	FALSE
ajcbbajabba	FALSE
deagibdcdfebiaacabba	FALSE
ghcbebjidejabfcbfacieabba	FALSE
djgebaabfghhfjfegedbaabba	FALSE
fbbabehgaeiadbhiffafahbba	FALSE
baccdjdijahhcdgggbebaabba	FALSE
dhhbdggceafcahefggbbaabba	FALSE
ideadccfffbbaabba	FALSE
eajeaeghbbiaabba	FALSE
hdbcibfahahabffeaibgaabba	FALSE
fgdjeabbaabba	FALSE
iafgdbbaabba	FALSE
jchbibabbaabba	FALSE
deagibdcdfebaabba	FALSE
ecdjiejhcjeehabbaabba	FALSE
ghhhedagaibhfibadabba	FALSE
hecfdigcbjhabcbaabba	FALSE
jieficcgbheacdgjabbfaabba	FALSE
fdddfghcffijhigabbaabba	FALSE
ibgdcfdddfghcffjabbaabba	FALSE
ecbabbaabba	FALSE
dfhabbaabba	FALSE
dfejecgbaifdigdhafbbaabba	FALSE
dhbabbaabba	FALSE
diabbaabba	FALSE
cbghfbaeajbbaabba	FALSE
gebibgcjahbbbaabba	FALSE
ijafhfidfjagigijeabbaabba	FALSE
ajcabcggahhjafbjbaabba	FALSE
hjghfgfhajecaaefcbabaabba	FALSE
fdahbeaiebfiadjagibedcbba	FALSE
baedjgebaabfghhaabba	FALSE
ijiafgfdddejjihfhbibaabba	FALSE
jhabhjjhjfhjfbbdeiibaabba	FALSE
ajeaeghhhedagaibhbiaabba	FALSE
gdhdegbgciabbaabba	FALSE
cifibbbabbaabba	FALSE
cbjfgaehbefddcjiabebaabba	FALSE
dchjhdigjbegidfgagbbaabba	FALSE
bhaidieidigbfbaabba	FALSE
bffdibbfiheagbcdhjhbaabba	FALSE
gbcdhbabbaabba	FALSE
jbcjgdcacjgihbbaabba	FALSE
hgjhijbbjgdcchcjacbbaabba	FALSE
agjdbbeadcjbdgeciageabbga	FALSE
fhfchbhdfcddgfahcibbaabba	FALSE
hiacehfhciadcabjhibiaabba	FALSE
eijbbaeechfhceehibabaabba	FALSE
dbafgdjdegfcbhaidbaabba	FALSE
agbbjaabba	FALSE
fgdjdegfabbaabba	FALSE
bhhcaicjfbgbeebbfebgaabba	FALSE
fijaibbaabba	FALSE
jbidffacicabjbaabba	FALSE
gcbjhhjhhjafgjfebcbaabba	FALSE
dfebihbcjcchbabbaabba	FALSE
feggiddjibcgcgdccabbaabba	FALSE
fgbbcfeijhfcdjdiafbbaabba	FALSE
bbjfjejgdajbjgjiabaabba	FALSE
hdeifehdijgfeahgdibbaabba	FALSE
jgiibcjjcigieabbaabba	FALSE
accagbbjaabba	FALSE
ciddhiddhabbaabba	FALSE
acaaafcgaihdhfcajbbeaabba	FALSE
cjdjiijabbaabba	FALSE
ijhcigbjhfjgigidhabbaabba	FALSE
hadgecdjiejhcjeebbaabba	FALSE
dacchfjdidbabaabba	FALSE
jcchbabbaabba	FALSE
cjbabbaabba	FALSE
ijahaeehhgiicbffdgbgaabba	FALSE
abfddejhifacfdchghbahabba	FALSE
bcabbaabba	FALSE
babbaabba	FALSE
babbaabba	FALSE
babbaabba	FALSE
babbaabba	FALSE
babbaabba	FALSE
babbaabba	FALSE
babbaabba	FALSE
babbaabba	FALSE
agdeideadccfffdjgcbbaabba	FALSE
jiedicedbdafdigibijbaabba	FALSE
ajeaeghhhedagaibhbaabba	FALSE
ajijgfhgacbbiiafgabba	FALSE
jhfeccdbahbbjcieiajaddbba	FALSE
hjajfbbgagfajcdebajdheiba	FALSE
djdegfcbhaidiebbaabba	FALSE
jeiecadbbfaabba	FALSE
gbjiddbfcjadchecfbhbaabba	FALSE
acbbiiafgdbafgdjdbba	FALSE
dedfabdcfijgiibcjjcaabba	FALSE
caficijjiifjafficbbcaabba	FALSE
cgejbcjgdcagbbaabba	FALSE
dceebgcgfejejgjdeabbaabba	FALSE
giahjhccbecdeaadbhahahbba	FALSE
fhbabbaabba	FALSE
dedfabdcfijgiibaabba	FALSE
diedifdgbdaaegigfebbaabba	FALSE
agbhdajeiecabjaabba	FALSE
abhbaabba	FALSE
heccdabcbehihhbjchbaiabba	FALSE
babdbaabba	FALSE
gcgfgagbieedehejgfibaabba	FALSE
jaaccagbjiddbacabba	FALSE
jdjiiehgabfddejhifbaabba	FALSE
dhdegbgchfcabbaabba	FALSE
bjhhjhhjafgjfeagbbaabba	FALSE
dhgbfhfgiagegaafgebbaabba	FALSE
fhhbbjbefddgfabbaabba	FALSE
cbaedjhbbaabba	FALSE
hahgeeahaajcbecibfaabba	FALSE
dacgaebhgaahbaabba	FALSE
hhfgieagjabidcdjeibjaabba	FALSE
iedacchfjdidbabaabba	FALSE
accagbjiddbfcjadjabba	FALSE
jedabbaabba	FALSE
fbbhjcdhejjgefhdgabbaabba	FALSE
ddhjahjghfgfhabjbaabba	FALSE
fecbaaejaedcgahgcbjbaabba	FALSE
cagbjiddbfcjaafbba	FALSE
jeffaffghddgjedhhbebaabba	FALSE
bgchfcajijgfhgacbbbaabba	FALSE
cdjiejhcjeehffabbaabba	FALSE
igieajbbaabba	FALSE
ffhijacgcfjiegegbbajabba	FALSE
abfddejhbaabba	FALSE
dbcdjaccfajaddfddabbaabba	FALSE
cagbjiddbfcaabba	FALSE
agbjibaabba	FALSE
jjcfgcibedgfghfheabbaabba	FALSE
bgcfbcdjgaegcebfhahbaabba	FALSE
jeebjfbbicfbbafchcbbaabba	FALSE
icabcecchgcdeaagiajbaabba	FALSE
afgdbafgdjdbaabba	FALSE
hfjdabbaabba	FALSE
ccagbjiddbfcjadchecabba	FALSE
bbfabjbaabba	FALSE
dgjedbfajifejidfbbaabba	FALSE
fijfhiejchbibiigfabbaabba	FALSE
iedacchfjdidgcbfbaabba	FALSE
jefeacaijijdfbjefgfbaabba	FALSE
dgbbeabfidcffjehahbbaabba	FALSE
jaibbaabba	FALSE
aahjciaecbbciegfidbhaabba	FALSE
ggjhcfhhbbjbefddjabbaabba	FALSE
chfcajijgfbbaabba	FALSE
acgebbaabba	FALSE
gbijbjfjbahhidbedcebaabba	FALSE
ebacajhfdhiiadahjgbbaabba	FALSE
ciddhiddhafhjbbaeabba	FALSE
iabbaabba	FALSE
hbahhcgiacgejbcjgjbaabba	FALSE
baedjbbaabba	FALSE
ddjghdichabfheegebddaabba	FALSE
hdahfbchcdgdjhecbaiadibba	FALSE
adggdhdebbaabba	FALSE
abbcchhidajbbhabba	FALSE
hhiejfejefjidegiaebbaabba	FALSE
hfcajjbbaabba	FALSE
hhhedagaibhfibadabba	FALSE
gdgbbiihjfgdjebadcbbaabba	FALSE
efahcdbhbbibcaihijhfababa	FALSE
abjhibaihfbbeichihccaibba	FALSE
agdeideadcjbbaabba	FALSE
ebhcahhcbaiccbjhgiaebabba	FALSE
jebeccijjhecfeebaibbaabba	FALSE
bcjjcigabfbaabba	FALSE
cgeajjeiecffbcceecjbaabba	FALSE
eeiabhdbidaejcifdiacfgbba	FALSE
fibbjfjejabbaabba	FALSE
cfjiegegebibgcabbaabba	FALSE
agfghgccbcdfaebibdijaabba	FALSE
hjiajbgfgehcagdgbjaijabba	FALSE
fababaabba	FALSE
bfjabbaabba	FALSE
ccicagjgbjicaajhjjdbaabba	FALSE
ejchbibiabbaabba	FALSE
ddddaadcjbcbbjjfhjaheabba	FALSE
gbbfhecbfhhhfiaabdbagabba	FALSE
jhgifidbiadejhjjddbbaabba	FALSE
agbjiddbacabba	FALSE
fhffgaaeggcgebiedjibaabba	FALSE
jfebgdcecjcbhgeabbgfaabba	FALSE
dbfajifejidfabagbaabba	FALSE
bdcfijgiiabbaabba	FALSE
iiddjhchgeaagcfbddhbaabba	FALSE
jfhiejchbibiigfbabbaabba	FALSE
bahfbbbeifjhjfdehdhaadbba	FALSE
deagibdcdfebihbcbaabba	FALSE
bhaidieidiggbabaabba	FALSE
aegbbaabba	FALSE
efdgdfceffhijacgcbibaabba	FALSE
ieidcjaddfjhgjfdjabbaabba	FALSE
ggjhabbaabba	FALSE
adacabdcafchggajhadbaabba	FALSE
dacchfjdibfbaabba	FALSE
dfdfdcjjfhebaaihbcjbaabba	FALSE
jijacedccbiecjgeidebaabba	FALSE
cbffdibbfiheagbgabaabba	FALSE
bffdjjajbbaabba	FALSE
aiechdjjgeaahbddcjbeaabba	FALSE
dfebihbcjccabbaabba	FALSE
jedahaajbbdedabhhfiefabba	FALSE
gegdbjahfiicjjjajcbbaabba	FALSE
hfbaeajbjbaabba	FALSE
eieeghedaccbiabjaeffeabba	FALSE
ieeedhccajagedhfdbbeaabba	FALSE
dhjhihhbedifjcjjabbaabba	FALSE
gbfedgbagaggjaigjabbaabba	FALSE
ccifaieadacjceaghbdbaabba	FALSE
diggjhchabbaabba	FALSE
cfdchghbahbabaabba	FALSE
bdcdabbaabba	FALSE
dbcfghhbabbaabba	FALSE
jdjiiehgabfddbcaabba	FALSE
fbjbchadgecdjbbaabba	FALSE
adccfffdjgcjdjbhbaabba	FALSE
haijjajicgghbfgecgcbaabba	FALSE
dacecgdjfedhjgjieebbaabba	FALSE
jhfjgigggbebgggfdabbaabba	FALSE
hhfjabbaabba	FALSE
hghbabbaabba	FALSE
fbgcfejaacaehbachcbbaabba	FALSE
abcggahhjafbjbchadgeafbba	FALSE
bbhgadbdhgejdhajhbgbaabba	FALSE
ffcegfcbhcijabbaabba	FALSE
gdeidjabbaabba	FALSE
fcbhcijabbaabba	FALSE
acdjhicfhdeajfcifebbaabba	FALSE
bjjfbhcebhjhjhhggabbaabba	FALSE
jedbfajifejidfbbaabba	FALSE
fejidfabadiefghahhbaabba	FALSE
hbjidiabbdjihefeeehfaabba	FALSE
jaibadjbbahgdgfdcjbeahbba	FALSE
fddjabbaabba	FALSE
gejbcjgdcacjgihabbaabba	FALSE
fedhhjfiecghcdjiagbbaabba	FALSE
cabbaabba	FALSE
cabbaabba	FALSE
jbcjgdcacjgihabbaabba	FALSE
ciabbaabba	FALSE
ciabbaabba	FALSE
