acddcfeefhchbheeacecech	TRUE
gceaga	TRUE
ahbdcdffca	TRUE
dghdfddedaeecdbdhfcg	TRUE
gcea	TRUE
acgcc	TRUE
fecafgddfehfbefbbdecfb	TRUE
e	TRUE
e	TRUE
e	TRUE
e	TRUE
e	TRUE
ahbdcdffcchhdbh	TRUE
hbhbhddgdgehhb	TRUE
gefhhcdghdfddedae	TRUE
fhhcdghb	TRUE
cgeffd	TRUE
gaaheefcgehh	TRUE
dbfaahbdcdffcchhdaefgfd	TRUE
daeaeagdffbggfacafahdgbb	TRUE
hfaaf	TRUE
agdbcfafdgdcadddhedebhg	TRUE
fchhbfhcebagaeadahaecgf	TRUE
daeecb	TRUE
ecdbdhfcg	TRUE
ecdheggfdehhghh	TRUE
ecdbdhfcgceagefahcfaeba	TRUE
bdba	TRUE
gdeab	TRUE
hhhgdfgfefbchhefe	TRUE
agdffbggfacafahdge	TRUE
dfbhdgddhea	TRUE
hhhgdfgfefbb	TRUE
bheffbca	TRUE
cebhdggaaheefcgefhhcdaf	TRUE
chhdaefgfcf	TRUE
hhdeaahbecffedfbbhgbh	TRUE
chhdaefgfcfceagdb	TRUE
hbdcdffc	TRUE
cgbheffbcgdbfaaah	TRUE
dcadddhedebe	TRUE
cdbdhfcgceagefahh	TRUE
fbb	TRUE
bfc	TRUE
chhdaefgfcfceagdbcfb	TRUE
ceagefahcfa	TRUE
geh	TRUE
fgfcfceagdbh	TRUE
bffeghgafacagde	TRUE
hdfddedaeecdbdhfcgceag	TRUE
bacegafbghabffefdffgh	TRUE
ddheacgbheffbd	TRUE
dahaecgfabdfchh	TRUE
dffbggfacafahdg	TRUE
a	TRUE
a	TRUE
a	TRUE
a	TRUE
a	TRUE
a	TRUE
a	TRUE
a	TRUE
a	TRUE
a	TRUE
a	TRUE
a	TRUE
a	TRUE
gefhhcdghdh	TRUE
acgbheffbdbbcbhg	TRUE
gefhh	TRUE
fbcdhgecdheggfdehhb	TRUE
gdeabace	TRUE
ab	TRUE
ab	TRUE
ab	TRUE
bacegafbgaa	TRUE
fcgefhhcdghdfddf	TRUE
fafdgdcbd	TRUE
daeecdbdhfcg	TRUE
eadahaecgfabdf	TRUE
afahdgecfchhbfhc	TRUE
egafbghabffefdff	TRUE
chfahgbddhfedhhgab	TRUE
cegaghh	TRUE
bacegafbghabffefdffbgg	TRUE
hhdaefgfcfceagdbcfb	TRUE
chf	TRUE
hhdaefgf	TRUE
dghdfddedaeecdbdhfcgc	TRUE
hfahgbddhfedhhbc	TRUE
agdbcfafdgdcadddhedebhff	TRUE
ecfaeehhfdacedhgdfeabbg	TRUE
ecgfabdfchhcchhhgdf	TRUE
gceagefahcfaebffegh	TRUE
hf	TRUE
aabhcegcfdhhdaegbc	TRUE
abhcegcfdhhdaegbc	TRUE
gdbfaab	TRUE
deabacegaghh	TRUE
cgeffdccfgdhfdgffcda	TRUE
fbghabcdghhecgeffdc	TRUE
dbfaahbdcdffca	TRUE
dcadddhedebecdhg	TRUE
ahbbhdcfeedffe	TRUE
hbbagdbacdaeaeaab	TRUE
hbecffedfbhdgddheacgbheb	TRUE
ebhdggaaheefcgefhhcdghdh	TRUE
afacgh	TRUE
hhhgdfgfefbchhefecaf	TRUE
hgafacfbbbhgffdh	TRUE
aheefcgefhhcad	TRUE
fafe	TRUE
aheef	TRUE
acgccebhdg	TRUE
fbbghegde	TRUE
faebffeh	TRUE
cgeh	TRUE
fdhhdaegebbdcbbdghhb	TRUE
bdfchhcchhhgdfgfefbchhh	TRUE
fdehhghfbdgdgaabhceg	TRUE
fafdgdcadddhedebe	TRUE
becdhggbb	TRUE
ffcdachfaaf	TRUE
hgbddhfa	TRUE
cfgdhb	TRUE
afacfbbbhgffdgdebgf	TRUE
fffhheaceccbffhgafbbgh	TRUE
ecfchhbfhcebag	TRUE
fdehhghfbdgdgaabhcegcfa	TRUE
acgcceba	TRUE
ahhdeab	TRUE
gc	TRUE
gc	TRUE
gccb	TRUE
gbheffb	TRUE
aaheefcbf	TRUE
gccebhdggaaheefcbf	TRUE
geffdccfgdhfdgffcd	TRUE
gccebhdggaaheefcgefhh	TRUE
cgbheffbcgdbfaahbdcdg	TRUE
dcadddhedebecdhgghbbg	TRUE
ad	TRUE
hhcchhhgdfgfeb	TRUE
cdaeaeagdffb	TRUE
dbfaahbdcdffcchhdaefgf	TRUE
ffcdachfahgbddhfa	TRUE
daeecdbdhfcgc	TRUE
dfhebgechffbhagafffhhea	TRUE
aaheefcgeh	TRUE
bcdghhecgeffdccfgdhfdgh	TRUE
cgeffdccf	TRUE
ceagefah	TRUE
fhhcdghdfddedaeechf	TRUE
agefahcfaebff	TRUE
hhdeaahbecfgf	TRUE
cdaeaeagdb	TRUE
dghdfddeda	TRUE
fahcfaebffeghgafacfbfb	TRUE
faeehhfdacedhgdfeabbg	TRUE
hgafacb	TRUE
chdfhebaahghegbbcfe	TRUE
eagefahcfaebffeghgaf	TRUE
hgafacfbbbhgffdgdebgffh	TRUE
cgeffdccfgdhfdb	TRUE
ffcda	TRUE
aaheef	TRUE
ahhdeaahbecffeh	TRUE
facfbbbh	TRUE
bfca	TRUE
dahaecgfabdfchhcchhhbb	TRUE
hhdeaahbecffeh	TRUE
g	TRUE
g	TRUE
g	TRUE
g	TRUE
g	TRUE
g	TRUE
dcadddheda	TRUE
aahbecffedaa	TRUE
eafdfh	TRUE
afahdgecfchhbfhca	TRUE
gefhhcdghdfdded	TRUE
ghgafacfbbbhg	TRUE
hbbagdbacdaeaea	TRUE
hbecffedaa	TRUE
aeagdffbggfacafahdg	TRUE
deabacegafbghheff	TRUE
fceagdbh	TRUE
abac	TRUE
gefhbh	TRUE
geffd	TRUE
daeaeagdffbggfacafahdge	TRUE
ghbhbhddgdgehhbaahbbhdh	TRUE
ehhbaahbbhdcfeedffed	TRUE
bagaeadahaecgfbf	TRUE
afahdgecfchhbfhcebeegf	TRUE
cgccag	TRUE
cdaeaeagdffbg	TRUE
heb	TRUE
dfgfefbchhefecafgddfb	TRUE
dhfdgffcd	TRUE
ahbbhdcfeedffedbdffeb	TRUE
bfcacgccebhd	TRUE
hhbaahbbhdcf	TRUE
eecdbda	TRUE
hgafacfbbbhgffdgdebgfebe	TRUE
dhhgahhde	TRUE
gffadfhebgechffbgggfb	TRUE
hhbaahbbhdcfeedffe	TRUE
fefbchhefecafgddfeb	TRUE
ag	TRUE
ag	TRUE
dgaabhcegcfdhhdaegb	TRUE
hhecgeffdccfgdhfd	TRUE
gd	TRUE
daeag	TRUE
gafb	TRUE
chhdaefgfcfceagb	TRUE
gh	TRUE
gdffbggfacafahdgecfa	TRUE
cgeffdccfgdb	TRUE
aa	TRUE
chhhgdfgfefbchh	TRUE
facfbbbhgffdgd	TRUE
facafahdgecfa	TRUE
bffeghgafacfbbbhg	TRUE
ffcdachfaaab	TRUE
acddcfeefhchbheeacece	TRUE
hbdcdffca	TRUE
bhdggaaheef	TRUE
cfchhbfhcebagae	TRUE
deabacegafbgh	TRUE
eh	TRUE
gefhhcd	TRUE
bfcacgccebhdgg	TRUE
dcadddhedebecdhggbbg	TRUE
cfbbghegdeabacegaghh	TRUE
ahbdcdffccha	TRUE
gbheffbcgdbf	TRUE
ahhdeaahbef	TRUE
fdfhgbhb	TRUE
aahe	TRUE
gbhefg	TRUE
fgdhfdgffd	TRUE
cdheggfdehhghfbdgd	TRUE
afdfhba	TRUE
fdhhdaegebbdcbbdgdhbcb	TRUE
cfchhbfhcebagaeadah	TRUE
ha	TRUE
ehh	TRUE
aahbef	TRUE
hfah	TRUE
bagaeadahaeea	TRUE
eagefahcf	TRUE
bfcacgccebhdggab	TRUE
gdbfaahbdcdffcchhdaefgfd	TRUE
hcf	TRUE
ecdbdhfc	TRUE
cfgdhfdgffcda	TRUE
habcdghhecgeffdccfgdhfdb	TRUE
bacegafbgh	TRUE
effdccfgdhfdgffd	TRUE
dhgghbhbhddgd	TRUE
hfahgbddhfedhhgahhdeab	TRUE
acgbheffbdbbh	TRUE
cgbheffbcgdbfaahbdg	TRUE
bac	TRUE
eagefahcfafe	TRUE
gaaheef	TRUE
fchhbfhcebagaeadah	TRUE
bffegh	TRUE
b	TRUE
b	TRUE
b	TRUE
b	TRUE
b	TRUE
b	TRUE
b	TRUE
b	TRUE
b	TRUE
b	TRUE
b	TRUE
b	TRUE
b	TRUE
b	TRUE
b	TRUE
b	TRUE
b	TRUE
b	TRUE
b	TRUE
b	TRUE
b	TRUE
b	TRUE
b	TRUE
b	TRUE
b	TRUE
b	TRUE
b	TRUE
b	TRUE
b	TRUE
b	TRUE
agefahcfaebffeghgafbb	TRUE
fgdhfdb	TRUE
bhdgg	TRUE
d	TRUE
d	TRUE
d	TRUE
d	TRUE
d	TRUE
d	TRUE
d	TRUE
d	TRUE
d	TRUE
efah	TRUE
gccebhd	TRUE
hfahgbddhfedhhgahhdeaaa	TRUE
ecgfabdfchhcchhhbb	TRUE
cgeffdcb	TRUE
cgccebhdggaaheefcgeh	TRUE
bhcbf	TRUE
hfahgbddhfedhhgahhde	TRUE
hhdaefgfcfceagdbcfafd	TRUE
ecdbdhfcgceageab	TRUE
bffeghgafacfbbbhgb	TRUE
bhcbfc	TRUE
fgfcfceagdbcf	TRUE
hghegbbhfcececfaeehhfd	TRUE
ceageab	TRUE
cegafbghabffeg	TRUE
hbhbhddgdgehhbba	TRUE
f	TRUE
f	TRUE
f	TRUE
f	TRUE
fdgdcadddheda	TRUE
dachfahgbddhfa	TRUE
dhgghbhbhdda	TRUE
cecfaeehhfdacedhgdf	TRUE
acececgffadfhebgechfag	TRUE
dhgghbhbhddgdgeha	TRUE
bddhfef	TRUE
fgfcfceagdbcfb	TRUE
daeecdbdhfcgceagefahcfab	TRUE
fc	TRUE
ffbcgdbfa	TRUE
ahhde	TRUE
hhdeaahbecffedgde	TRUE
aeagdffbggf	TRUE
fecafgddfehfbeb	TRUE
cecfaeehhfdacedhgdfe	TRUE
hdfhebaahghegbbcfeeff	TRUE
hbhbhddgdgehhbaahbbhdcfe	TRUE
eba	TRUE
eba	TRUE
ahbecffedfbbhgbgbceg	TRUE
chfahgbdh	TRUE
bhcbfcacgccag	TRUE
hfahgbddhfeda	TRUE
aeadahaecgfabdfchhcchhha	TRUE
hegdeab	TRUE
bcdghhecgeffd	TRUE
hfahgbddhf	TRUE
fbbgh	TRUE
bacegafbghabffg	TRUE
ececfaeehhfdacedha	TRUE
gdeaba	TRUE
aahbecffedfbbhgbgbc	TRUE
aahbecffedfbbhgbgb	TRUE
dgehhbaahbbhdcfeedf	TRUE
ahbecffeh	TRUE
agefahcfab	TRUE
dhhgab	TRUE
dddhedebeca	TRUE
cfgdhfdgffcdachfahhda	TRUE
chdfhebaahghegbbcf	TRUE
fceagdbcfafdgdcadddhed	TRUE
efc	TRUE
chhhgdfgfefbchhh	TRUE
ahb	TRUE
afgddfehfbefbbdec	TRUE
aeadahaecgga	TRUE
gebbfdgchdfhebaahghehce	TRUE
ggfdehhghfbdgdgaabhceg	TRUE
cfgdb	TRUE
cffedaa	TRUE
bacegaghh	TRUE
aeadahaecgfabdfca	TRUE
gfacafahdgba	TRUE
afgddfehfbefbbde	TRUE
ffedfbhdgddheacgbheffbd	TRUE
eagef	TRUE
dhhgahhdea	TRUE
bacegafbghabffefdf	TRUE
hhbaahbbhg	TRUE
echf	TRUE
bffeghgafbb	TRUE
bheffbcgdbfaahbdcdff	TRUE
hgaf	TRUE
aeadahaecgfabdfchhccb	TRUE
eagdbcfafda	TRUE
aeaff	TRUE
hbbagdbacda	TRUE
cffedaac	TRUE
dachhh	TRUE
dcadddhedebecdhgha	TRUE
afbghabb	TRUE
cafahdgecfa	TRUE
aahb	TRUE
bhcbfcacgcc	TRUE
bb	TRUE
dghdh	TRUE
hbhbhddgdga	TRUE
geffdccfgdhfdb	TRUE
ffcdachf	TRUE
cgc	TRUE
ecdbdhfcgceagefahh	TRUE
agdffbggfacafb	TRUE
c	TRUE
c	TRUE
c	TRUE
c	TRUE
c	TRUE
fgdhfdgffcdachfaaab	TRUE
ddheacgbh	TRUE
gbheffbcgf	TRUE
dffccha	TRUE
aabhcegcfdhhdaeg	TRUE
eecdbdhfcgceag	TRUE
gef	TRUE
ehhbaahbbhdcf	TRUE
cfbh	TRUE
geffdccfgdb	TRUE
fahcfaebffeghg	TRUE
gbheffbcgbh	TRUE
hgb	TRUE
cgeffdc	TRUE
aah	TRUE
hdfdded	TRUE
cdaeaeagdffbggfa	TRUE
gdbcfafdgdcadda	TRUE
afgddfehfbefbbdecfhedhg	TRUE
gce	TRUE
gfacafahdgecfchhbfhca	TRUE
cedhgdfeabbgheghfgchcb	TRUE
habh	TRUE
dfbhea	TRUE
fgfcfceagb	TRUE
dhgecdheggfdehhghfbdh	TRUE
dachfah	TRUE
ecdheggfdehhghgd	TRUE
cfbb	TRUE
chhdaefgfcfceagdbh	TRUE
becdhgghbhbhddgdgehhba	TRUE
ee	TRUE
egaghh	TRUE
dachfahgbddhfef	TRUE
hgafacagde	TRUE
acgccebhdggaaheef	TRUE
hgafa	TRUE
hgafacfbbbhg	TRUE
dcadddhedebecdhggbb	TRUE
ddfehfbefbcdhgecdheg	TRUE
hegd	TRUE
fcbf	TRUE
fecafgddfehfbefbbh	TRUE
acgbheffbdbbcbggbf	TRUE
dhgghbhbha	TRUE
hbdcdffcchhda	TRUE
eecdbdhfcgceaga	TRUE
cegba	TRUE
dgehhbaab	TRUE
ccebhdggaaheefcgefhhcd	TRUE
cdheggfdehhghfbdh	TRUE
gccebhdggaaheef	TRUE
daeecdbdhfc	TRUE
fa	TRUE
aaheefcg	TRUE
hbbagdbacdaeaeagdffbfh	TRUE
hbecffedfbhdgddh	TRUE
ddheacgbheffbhb	TRUE
fgfcfceab	TRUE
bfcacgccb	TRUE
ebffeghgb	TRUE
dcadddhedebeca	TRUE
gba	TRUE
bcdghhecga	TRUE
bbdgacddcfeefhchbhee	TRUE
ecdbdhfcgc	TRUE
abhcegcfdhhdaegebedcb	TRUE
bagaeadahaecgfabdfca	TRUE
dachfahgbddhfedhhgahhdea	TRUE
dae	TRUE
cffedfbhdgddheacgbhefg	TRUE
acgccebhdggaaheefcg	TRUE
dhgghbhbhddgdga	TRUE
dbfaab	TRUE
hcfab	TRUE
eccbffhgafbhbcdegdbefbf	TRUE
aaheefcgefhbh	TRUE
hhdeaahb	TRUE
ghfeahdbba	FALSE
fagefhccabefdba	FALSE
fddhdfbdehefcddbcfhfafbba	FALSE
dhehaddecbhdagdaeheaba	FALSE
dbbahfehbageffehggchbceea	FALSE
bahaegcffbgba	FALSE
dacfhceceecfhfcgdabba	FALSE
fgdhehaddabba	FALSE
fedhebfcdbchegchbbabba	FALSE
gfacdbbdba	FALSE
hgddhafeggfagefhccabefba	FALSE
hhcdhdaeabeghfeahdachcbha	FALSE
ecddcgbhabba	FALSE
fbbghabba	FALSE
bhghcccaefhbba	FALSE
hhcdhdabba	FALSE
ghfeahdachcbdbfcbba	FALSE
dbfgbafdbbcchgfefhhgfadf	FALSE
gfgbdfdacgcbba	FALSE
gbahedchgfghcbghbffcefefa	FALSE
dheeafdggcgbhhdabfa	FALSE
hhgabba	FALSE
aabaeafghbaf	FALSE
fbghabba	FALSE
eadccgahegfdehbhdhba	FALSE
fbgdhbehhccgegbahebfacbae	FALSE
ebcbfecccfehbafbba	FALSE
aefafgfabba	FALSE
agaedabcfgedfhcaadcegbad	FALSE
dgbdagfgbdfdacgcaeba	FALSE
aefaebgggdhdacabbfcgbeeba	FALSE
efgfabba	FALSE
facbba	FALSE
fedhebfcdbabba	FALSE
bedheeafdggcgbhhdaba	FALSE
hchacgcbcdabhhcgeadafffeb	FALSE
bfcdbchegcbhabba	FALSE
ghhgefddeaacffgbcbefchcaa	FALSE
gdaehegdbdhebahgf	FALSE
eeffheffeedfgdcdcgfacgbba	FALSE
faefbeecddcgbgfha	FALSE
eafbba	FALSE
geafgceaebdgagaedabcfa	FALSE
bdbfcabfba	FALSE
dhebfcdabba	FALSE
hfchhggfgfgeggedeahefbeba	FALSE
gfacdbbdbacfaghcbcadb	FALSE
ffcfbfcadcbehbdggfah	FALSE
cffdfegcdhhhcbaadhdebcbga	FALSE
dcgfacdbbdba	FALSE
dfcfedccgeffhdfahgdhafbba	FALSE
fbfcadcbgba	FALSE
fgfddbddghhcfegdhadahebba	FALSE
bfcdbahbba	FALSE
ccaefhgaaabaeafghahffba	FALSE
fbbghdggbdcdabbfdeafcebch	FALSE
beghfeahdachcbdbfcea	FALSE
bcgcgebabba	FALSE
cdhcabheahebahaegca	FALSE
dfgfgdhehaddecbhdagba	FALSE
hhecgabba	FALSE
gabba	FALSE
gabba	FALSE
gabba	FALSE
fadbbcbbfbgah	FALSE
cbaddgbedaeaacfceccaedbga	FALSE
abeghfeahdachcbdba	FALSE
ddcgbgdbfdabhba	FALSE
ffheffeedfabba	FALSE
cfbabba	FALSE
bgdbfdhhhacfcbhghcccaeba	FALSE
gcgehbaccfbba	FALSE
adbahfefghdgcdeadggbfgfag	FALSE
hfchhggfgfgeggedeahebba	FALSE
dabba	FALSE
dbgabba	FALSE
chhfgcfabba	FALSE
hhgabbea	FALSE
hcccaefhgaaabbba	FALSE
afdggcgbhhdabfaecdege	FALSE
eecdabba	FALSE
dbacdddbadacfhceba	FALSE
bdbfcebedgbdagfgbdfba	FALSE
eagdbfgbafdbb	FALSE
hahffedghefebba	FALSE
eedbcedafghcegdccbfgbfhga	FALSE
bcdbacdddbadacfhcecebba	FALSE
dccgahegfdehbhdhgbcbddaf	FALSE
dhdebcegebgbhcabba	FALSE
dbfdhhhacfcbhghccba	FALSE
afadbbcbbfbgeeffadc	FALSE
gdaehegdbba	FALSE
dcadbba	FALSE
ffcfbfcadcbehbdggfeda	FALSE
faghcbcadfba	FALSE
cfcbhghcccaefhgaaabbba	FALSE
ccdhcabheahebahaegcff	FALSE
gfacdbbdbacfab	FALSE
hdchbfbaadcdegdbdedbgfgha	FALSE
fghghegcdeafechbdgcfacaba	FALSE
dhebfcdbchaabba	FALSE
bfcdbchegchhfgcffabba	FALSE
caabba	FALSE
caabba	FALSE
ddecbhdagdaehegdbba	FALSE
bhghcccaebba	FALSE
eagdbfgbafdbbc	FALSE
dbdgfgdbaeabfegdfbfbccadb	FALSE
cgcfeghhcfgaahehaefbeccba	FALSE
dhdebcegebgabba	FALSE
dfdfaeaefafbba	FALSE
haabba	FALSE
bdbgdaagbdbhhhghdhbehdhca	FALSE
hcbcadfdfaeaefafbcba	FALSE
heaacbbgggfgbggabfagaeeab	FALSE
bdbfcebedabba	FALSE
afahdgbba	FALSE
cfcbhghcccaefhbba	FALSE
cfcbhghcdabba	FALSE
ffgffcfbfcadcbgba	FALSE
cdadcbaggbfedddgfhhagcagc	FALSE
hefeaceadccgaheabba	FALSE
dbbcbbfbgeeffhefffabba	FALSE
hdbhfddgaghbgahdbgheddgea	FALSE
afbghba	FALSE
behbdggfedhebfcdbchegabba	FALSE
agedaeedfbaegfgcebcaagcfg	FALSE
abefdagcbeebcbfbacb	FALSE
hbabba	FALSE
bhdfbbedgcdggfdfdaaddbbga	FALSE
bddfbfaddbgbcgcha	FALSE
ccebfcfbddedeebeecfhfabba	FALSE
dffcabba	FALSE
eaefafgfaefbeecddcbha	FALSE
dghabba	FALSE
gceabgba	FALSE
dfhffhedeheefbhhcecfhabba	FALSE
bdbfcebedgbabba	FALSE
bdbfcebeabba	FALSE
ghcbcadfdfaeaeabba	FALSE
aceadcchabba	FALSE
hhbfabba	FALSE
gchhfgcffdfegcgabba	FALSE
aedgeagdbfgbafdbbcchggf	FALSE
gdbdhebahgddhafeggfbcba	FALSE
becaehbba	FALSE
aabhba	FALSE
ghcbcadfdfaeaebba	FALSE
fbchgggaggafecdadfcfhfbba	FALSE
fchbedcbfghagcghcdhgbdaba	FALSE
gadabba	FALSE
ccfehbaffcbcdbacdddb	FALSE
feggfagefhccabeba	FALSE
eahhcdhdaeabbca	FALSE
cffgffcfbahbba	FALSE
dchecdehcgbcfehccddagbaba	FALSE
gcaedghbbba	FALSE
abeghfeahdaba	FALSE
dfhcaadcegaacbcadcbhagfdb	FALSE
dacfhceceecfhfcgdbba	FALSE
fafdgbhba	FALSE
hhcdggechfbchfhfghcgeabba	FALSE
gcbeebcbfecccabba	FALSE
behbdghgabba	FALSE
hffedghefeaceadccgaheabba	FALSE
gfgbdfdacgcaedgbbba	FALSE
bbhgedheghaehfaefafghbgba	FALSE
ebgbgbfgeabbba	FALSE
adcegaacbcadcbhagfchgbh	FALSE
dfgfgdhehaddecbba	FALSE
ccheacafbdchgaafgceedcbba	FALSE
gcbeebcbfecccfehbaffcbcba	FALSE
ebgbgbfgeahhcdhdaeabbca	FALSE
fdehbhdhabbga	FALSE
hdhdcaecgcbhfefdcceeegbda	FALSE
bgfbggdhddbfccfgaebhfcbba	FALSE
hegdbdhebahgddhafebba	FALSE
ecddcgbgdbfdhhhacfcbhba	FALSE
adcbacbchcbcaahbehfgbgdaa	FALSE
bddfbfaddbgbcgcgehba	FALSE
chdfdfadfgcbfechdfbhfbcba	FALSE
ahebahaeaba	FALSE
bhabba	FALSE
dghefeaceadccbba	FALSE
hcbcadfdfaebbea	FALSE
gfdehbhdhgbfabba	FALSE
dhhhcbaadhbba	FALSE
bhegfabba	FALSE
beabba	FALSE
dghefeaceadccgaheabba	FALSE
ehddfbffbfbafahdbfgeeafba	FALSE
dfgfgdhehadfbba	FALSE
ffeedfgdcdcghabba	FALSE
bchaaffhhcfcabeechffhhbga	FALSE
gdhdgafcfhdchbgagehghgfba	FALSE
gbhhdabfaecdegeafgceaeba	FALSE
eehcbaggdbdfcfceafdfcdbha	FALSE
gfbggbehacedefdfbhffgdfba	FALSE
ebedgbdagfgbdfdaba	FALSE
eafadbbcbbfbgeba	FALSE
eadccgahegbbga	FALSE
hgfefhhgfadbba	FALSE
aedgeagdbfgbafdbbc	FALSE
dcafabba	FALSE
hbbagabba	FALSE
chgfefhhgabba	FALSE
ahhcdhdaeabeghba	FALSE
caabacba	FALSE
bcbddfbfaddbgbcgcha	FALSE
hhcdhdaeabeghfaba	FALSE
ffeedfgabba	FALSE
hdceecdgchgcebeaceaegcbba	FALSE
ddhcfbhabcafaegccdfacgaba	FALSE
dhehaddecbhgba	FALSE
cfcbhghcccaefhgaaabaeafba	FALSE
fadfgfgdhehabgba	FALSE
dacaaahaehafagegdecfchbba	FALSE
ehdabba	FALSE
dbfdhhhacfcbhghccgba	FALSE
ffeedfgdcabba	FALSE
bbcgeahcdgdddabbdfbfhdfga	FALSE
fgdhehaddecbhdagdaeheaba	FALSE
dddbadacfhceceecfhbdba	FALSE
hbbcbbdhdehbadadfbegfhbea	FALSE
fggaehafadaadbadhgaeacgba	FALSE
fabba	FALSE
cabdeeefbgabhcgcggdhgdcdh	FALSE
dbcabba	FALSE
bbegaadfdbebcgghgccgcedha	FALSE
bdbfcebedgbdagfgbdfdaba	FALSE
bheahebahaegcffgffcfbfcad	FALSE
ffabbha	FALSE
afadbbcbbfbgeeffa	FALSE
cgfabbga	FALSE
ccaefhgaaabaeba	FALSE
cdbbdbacfaghcbcadfdfabba	FALSE
fadeafaaacbacgdfbagehdaab	FALSE
cdhhabgbfga	FALSE
agdbba	FALSE
gfacbeba	FALSE
ffgffcfbfcadcbehbdggfah	FALSE
adhdebcegebgbgbfgeba	FALSE
bcgcgehbaccdbhba	FALSE
egebgbgbgabba	FALSE
bafebeedfcgbhhdeaeehhagch	FALSE
hhdeaabba	FALSE
dbfgbafdbbcchgha	FALSE
fbabba	FALSE
ceabba	FALSE
eabba	FALSE
cdddbadacfhceceecfhfcbaba	FALSE
hbbeabba	FALSE
cggabba	FALSE
cbchhbccgacbaaaddaagdffba	FALSE
fhgaaabbba	FALSE
bbfbgeeffheffeedfgdcabba	FALSE
bdagfgbdfdacgcaedgeagghba	FALSE
egcffgffcfbfcadcbehbdgga	FALSE
fafgfaefbeecdbab	FALSE
babba	FALSE
babba	FALSE
babba	FALSE
babba	FALSE
babba	FALSE
babba	FALSE
dccgahegfdebfba	FALSE
bacegbbca	FALSE
fadbbcbbfa	FALSE
gebgbgbfgeahhcdhdaebba	FALSE
fdfbabba	FALSE
hfeahdabfba	FALSE
hgfefhhgfadfgfgdbba	FALSE
eeebdfdhhahhefbfcfbgegcab	FALSE
dchccgbccdbhecdfeeddeabba	FALSE
hhbabba	FALSE
facdbbdbacf	FALSE
bfffhdfccabhghbhggghgchaa	FALSE
bhghcccaefhgaaabba	FALSE
gccebabba	FALSE
dghefeaceadccgahegbbga	FALSE
hdachcbdbfcebeba	FALSE
dfgfgdhehaddecbhdagdaba	FALSE
bheabba	FALSE
gcgchegbhadbgbcbfgbffdaga	FALSE
dfhcaadcegaacbcadghaba	FALSE
ddbgbcgcgehbaccdhcabbea	FALSE
cfaghcbcadfdfaba	FALSE
cchegghbcedffdeebacafabba	FALSE
gdbcabba	FALSE
bdbebhfbbhbcdcahccheahbba	FALSE
fgefgcbadhcfagehabcebfhac	FALSE
aaabaeafbaa	FALSE
hhbfhabba	FALSE
ddcaabcfeahagdeeegagbddah	FALSE
bcbddfbfaddbgbcgcgehbacce	FALSE
ffdfegcdhhabgbfga	FALSE
bfcdbchegchhfaabba	FALSE
eeffheffeedfgdcdcghabba	FALSE
fhgaaabaeafghahffba	FALSE
baeafghahffedgbba	FALSE
bcbddfbfaddbgbcgcgeha	FALSE
egacbcdhfdhbhgfafbbgfhabh	FALSE
hdgedfchbehdhhgaceddabbba	FALSE
fhccabefdagcbeebcbfa	FALSE
gchhfgcffdfegcdhabba	FALSE
ddbgbcgcgebabba	FALSE
ecddchabba	FALSE
ggedeahefaecfhceghdbba	FALSE
haebba	FALSE
eeffhbabba	FALSE
dghefhabba	FALSE
ffheffeeabba	FALSE
hhcdhdaebba	FALSE
aefafgfaefbeecddcba	FALSE
faghcbcbae	FALSE
afgdccacfbabahffhdbhceffe	FALSE
ghcbcadfbba	FALSE
abfba	FALSE
aceadccgahegfhbba	FALSE
gaeadbba	FALSE
accdddgceebdbfhbfbddaeehf	FALSE
cccfehbaffcbcdbacdddb	FALSE
gchhfgcffdfegcdhhhbabba	FALSE
hagbba	FALSE
ddecbhdagdaehegdbbba	FALSE
facdbbdbacfaghcbcaa	FALSE
bbfbgeeffheffeedfabba	FALSE
hhcdhdaeabeghfeahdaba	FALSE
dfccafabagegecgebgacchbcb	FALSE
cdbabba	FALSE
fcfceabba	FALSE
gfagefhccabefdagba	FALSE
hdgchbhhbeaehehcbchaaebfa	FALSE
fgbdfdacgcbba	FALSE
gcgbghhfabhdehhcgeccegbda	FALSE
dhhhcbaadhdebcegebage	FALSE
dccbhgfdcahfedhfffchabbah	FALSE
bdfdacgcaedbfba	FALSE
gcgehbaccdhcabheahebah	FALSE
edbahfaegfgcfdagdffdeabba	FALSE
fagcegefbbhbgbedebeefccad	FALSE
dfgfgdhehaddecbhdagdaebda	FALSE
adbccgbcabadhffbddbddffah	FALSE
aheefbfba	FALSE
eafghahffebba	FALSE
bedheeafdggcgbhhdabfaeb	FALSE
bdbfcebedgbdaabba	FALSE
edafbbfgbgcbgdcfaegcaaebb	FALSE
gdbdhebahgabba	FALSE
fghahffedghefebbba	FALSE
gcaedgeagdbfgbafdbbbf	FALSE
efafgfabba	FALSE
fcbhghcccaefhgaaabbba	FALSE
heebabba	FALSE
hgfefhhgfadfgfhbba	FALSE
daeecabba	FALSE
cffdfegcabba	FALSE
dheeafdggcgbhhdabfaecd	FALSE
dbhcbcegdfaebhfhddeaagbaa	FALSE
dbdcefcbedffgdfgfbaahfbba	FALSE
cchdceecbaddebhbaeaffhbhh	FALSE
dhebfcdbchegcabba	FALSE
ffeedfgdcdcgfahbba	FALSE
eaefafgfabba	FALSE
adabba	FALSE
efbghdhecacebdcbhhhgcdgea	FALSE
ddchbgeabba	FALSE
dhbhahbahhaghfggfffdehbea	FALSE
deababa	FALSE
hhcdhdaebaba	FALSE
dfgdcdcgfacdbbdbacfa	FALSE
ahebahaegcffgba	FALSE
cebhabba	FALSE
eadccgabbaf	FALSE
dgegfaecccaaeagddedefbbba	FALSE
gbhghefhebfeaedgfeedaabba	FALSE
ffedhabba	FALSE
fadbbcbbfbga	FALSE
acfbfbhhaedahbdcgcdhgeefe	FALSE
afbghhdaaaecabfhccdhfhfha	FALSE
efafgfaefbbha	FALSE
ahfgdbfbgachfgccdcbhaadad	FALSE
ggffdgbbgdddfhcgafbahabea	FALSE
ebcbfecccfehbaffcbcdba	FALSE
feaceadccgbba	FALSE
hhfgcffdhdabba	FALSE
beecffagabbgceccdffecghba	FALSE
aafbfdgddafeghhcchchdahba	FALSE
gcaedgbbba	FALSE
caedgeagdbfgbafaf	FALSE
bahgddhafeggfagefhccabeba	FALSE
baeafghahfabba	FALSE
adfhghcfdhgabghbagcafhfcf	FALSE
bcbddfbfaddbgbcgca	FALSE
cdbbdbacfaghcbcadfdfba	FALSE
ecddcgbgdbfdhhabba	FALSE
eafgceaebdgagaedabcfgha	FALSE
gdffbabba	FALSE
dhebfcdbchegchhfgcffabba	FALSE
bfaecdegeafgceaebdgagabfa	FALSE
fhceceecfhfcgdfabba	FALSE
hhbgeafadbbhga	FALSE
hgddhafeggfagefhccbgba	FALSE
cdhcabheahebahaegcff	FALSE
fbfcadcbehbdggfefca	FALSE
aeagdbba	FALSE
aaabaeafghahffedghefeaba	FALSE
hcbcadfdfaeaefafgfaefbbha	FALSE
bhaffehccgdefgfehfhahabba	FALSE
aggdafcdbabcddcfccbgafgab	FALSE
dfgdcdcgfacgbba	FALSE
bhagfchdbhhfbabhahfchhgb	FALSE
egcffgffcfbfcabgba	FALSE
gaeghdhgfhdbgdggdagbfgcca	FALSE
fadbbcbbfbgeeffheffa	FALSE
cdhcabheahebahaeg	FALSE
dhebfcdbahbba	FALSE
egcffgffcfbfcadcbehbda	FALSE
hcgbfedeahacecaeahedabbfa	FALSE
cdbbdbacfbbae	FALSE
bcegebgbgbfgeahabba	FALSE
egcfahbgba	FALSE
bhdagdaehegdbdhbfa	FALSE
abheahebah	FALSE
haabeegeebfaegcgfagedchcd	FALSE
gdbdhebahgddhbba	FALSE
cgacdehefbddfecebgcccafed	FALSE
bedgbdagfgbdfdacgcaedgba	FALSE
fgdhehadfbba	FALSE
gfdeabdaba	FALSE
gefgabafdfbdcadchdhaebgbc	FALSE
ffgffcfbabba	FALSE
bcgcgeaabbea	FALSE
gcgehbaccdbhba	FALSE
hbaccdhcabheahebah	FALSE
egabba	FALSE
cffgffcfbfcabgba	FALSE
dbfaabba	FALSE
efabba	FALSE
facbddffccdccaagheeefbfad	FALSE
aeadahbba	FALSE
bgegbccfdcfbdaabhggcbdbah	FALSE
beebcbfeccfcabba	FALSE
gefahbaba	FALSE
afdgbba	FALSE
ecddcahhbba	FALSE
geeecgbdaecdhcghabfgcebha	FALSE
bhghcccabba	FALSE
gfgbdfdacbba	FALSE
gfgbdfdacgcaedgeagbaba	FALSE
baadhdebcbga	FALSE
fdbbcchgfefabba	FALSE
hefeaceadccgahegfdebfba	FALSE
ghcbcadfdfaeaefafgfabba	FALSE
ceabgba	FALSE
hcbdbfcebeabba	FALSE
dhdebcegebgbabba	FALSE
fdagcbeebcbfecccfehbaff	FALSE
gcdadhafeeafacdgdeceebbba	FALSE
bahgddhafeggfagebba	FALSE
cgehbacbba	FALSE
hfeahdachcbdbfcebedgba	FALSE
ahhcdhdaeabeghfeahdacbfa	FALSE
bfdcheghhadegdhccfaedabba	FALSE
cdaebba	FALSE
deghedgbagdhabbfbbgghebha	FALSE
eafadbbcbbfbgeeffa	FALSE
debabba	FALSE
fbfcadcbehbdgga	FALSE
fcbhghabba	FALSE
dgabba	FALSE
dhhabgbfga	FALSE
dfgdcdcgfacdbbda	FALSE
gehehfchbcbbchddehhdadbba	FALSE
cdddbadacfhceceecfhfbfba	FALSE
gfagefhccabefdba	FALSE
cafbba	FALSE
bcgcgehbaccdhcabheahebah	FALSE
cedfhebgdfhfgdcghabghhfba	FALSE
abaeafghahffedghefba	FALSE
dgdhfcdcdhgdbgehgechgabba	FALSE
dhhhcbaadhdebcegebgbgbfa	FALSE
efafgfaefbeecddcgbgfha	FALSE
agdbfgbafdbbcchgffeh	FALSE
ahbba	FALSE
afadbbcbbfbgeba	FALSE
gefhccabefdagcbeebcba	FALSE
fbeecddcahhbba	FALSE
ccghhacfdcafacgffahggdbba	FALSE
cadbhhfecbdggbgbachcecadh	FALSE
fgbdfdacgcaedbba	FALSE
gbbddhfcfcghgcehheabdchba	FALSE
dgeagdbfbfab	FALSE
ehegdbdhebaabba	FALSE
cbeebcbfecccfehbaffcbcba	FALSE
bcehcbfabhdfbfeedgbddebha	FALSE
cabba	FALSE
hcgggadeacfbhacehabcgecga	FALSE
cfgdabbha	FALSE
aadhacgchheegcfedadfehbba	FALSE
